111111
1C00E1
101001
1P00C1
111111