1111111111111
1E00000000011
1101011111111
1P101110C0001
1111111111111