11111
1E001
11C01
10101
1P001
11111