1111111111111
1001000000001
1000011111001
1PCE110000001
1111111111111